cccclxxiii : quadringenti_septuaginta_tres
ccccmo : quadringentesimus
ccxcii : ducenti_nonaginta_duo
cd : quadringenti
dccccxlii : nongenti_quadraginta_duo
dccclxxxiii : octingenti_octoginta_tres
dccclxxxiv : octingenti_octoginta_quattuor
dcclxxiiii : septingenti_septuaginta_quattuor
dcxc : sescenti_nonaginta
dlxxxix : quingenti_undenonaginta
ix : novem
lviiii : undesexaginta
lxxii : septuaginta_duo
lxxx : octoginta
mcccxxxvi : mille_trecenti_triginta_sex
mdclvi : mille_sescenti_quinquaginta_sex
v : quinque
vii : septem
viii : octo
xi : undecim
xiiii : quattuordecim
xiv : quattuordecim
xixno : undevicesimus
xliiii : quadraginta_quattuor
xv : quindecim
xviii : duodeviginti
xx : viginti
xxi : viginti_unus
xxv : viginti_quinque
xxvi : viginti_sex
xxviii : duodetriginta
xxvto : vicesimus quintus
xxxta : tricesimus
